1	0	0	512	192						
10	0	0	256	96						
100	0	0	128	48	1	3				
101	128	0	128	48	1	2	7			
102	128	48	128	48	2	6	7	15	17	29	30	31	32
103	0	48	128	48	3					
11	256	0	256	96						
110	256	0	128	48	7	8	10	26	27	28	
111	384	0	128	48	10	11				
112	384	48	128	48	11	20	24			
113	256	48	128	48	6	7	8			
12	256	96	256	96						
120	256	96	128	48	6					
121	384	96	128	48	9	13	14			
122	384	144	128	48	5	9	12	13	14	33	18	19	22	23	16
123	256	144	128	48	5	12	16		
13	0	96	256	96						
130	0	96	128	48	3	4	18	19	21	22	23	25
131	128	96	128	48	6	15	18	19	
132	128	144	128	48	5	18	19	22	23	25	16
133	0	144	128	48	3	4	5	18	19	22	23	25	16