12	49
14
1	1
23
42	500	133	134	135	132
71	500	172	186	200	214
72	500	214	200	186	172
73	500	225	226	227	224
74	500	239	240	241	238
75	500	287	288	289	286
76	500	301	302	303	300
77	500	227	226	225	224
78	500	241	240	239	238
79	500	289	288	287	286
80	500	303	302	301	300
81	500	168	198	196	170
82	500	169	199	197	171
83	500	182	212	210	184
84	500	183	213	211	185
85	500	170	196	198	168
86	500	171	197	199	169
87	500	184	210	212	182
88	500	185	211	213	182
89	500	339	340	367	368
90	500	353	354	381	382
91	500	313	327	341	355
92	500	314	328	342	356
86	87	281	85	86	86	86	86	86	86	86	86	86	86	86	86	86	86	86	86	86	86	86	86	86	86	86	86	86	86	86	86	86	86	86	86	86	86	86	86	86	86	86	86	86	86	86	86	87
86	87	281	85	86	100	100	100	86	86	100	100	100	100	100	100	100	100	100	100	100	100	100	100	100	100	100	100	100	100	100	100	100	100	86	86	86	100	100	100	100	100	100	100	86	86	86	86	87
86	87	281	85	87	175	175	175	85	87	175	175	175	175	175	174	175	175	175	174	175	175	175	175	175	175	175	175	175	174	175	175	175	175	85	86	87	281	190	175	175	174	175	175	85	86	86	86	87
86	87	281	85	87	218	218	218	85	87	218	189	204	191	218	188	218	218	189	188	204	204	204	204	204	204	191	218	189	188	204	204	204	204	99	100	101	281	203	204	204	188	204	204	85	86	86	86	87
86	101	281	99	101	8100	8200	281	99	101	281	203	204	205	113	114	115	281	217	188	218	218	218	189	204	204	205	281	217	188	218	218	218	189	175	174	176	281	217	218	218	188	218	218	85	86	86	86	101
87	175	204	176	281	8300	8400	9002	281	281	281	217	218	219	281	174	281	281	281	188	281	281	281	203	204	204	205	281	281	188	281	281	281	217	218	188	219	281	281	281	281	188	281	281	99	100	100	101	233
87	218	218	219	281	281	9000	281	9000	281	9100	9200	281	281	8100	188	281	88	114	114	78	256	281	217	218	218	219	281	113	114	115	281	281	281	281	188	281	281	8100	8200	113	114	115	7100	281	281	281	146	247
105	106	92	281	281	281	281	9002	8100	8200	8900	281	281	281	8300	188	88	89	86	86	86	270	78	256	281	281	281	281	281	174	281	281	7100	281	281	188	281	281	8300	8400	281	174	7600	7300	281	281	281	160	261
86	86	91	92	281	281	281	281	104	8400	281	281	281	88	72	72	89	86	86	86	86	86	86	270	78	256	281	281	281	188	8200	7600	7300	281	88	72	92	281	7802	7500	281	188	7300	281	255	75	72	73	275
86	86	86	91	92	281	281	281	284	281	281	281	88	89	86	86	86	86	86	86	86	86	86	86	86	270	78	256	281	188	8400	7302	281	88	86	86	86	92	281	7800	8100	188	255	75	269	86	86	86	73
86	86	86	86	91	73	4200	4200	284	4200	4200	71	89	86	86	86	86	86	86	86	86	86	86	86	86	86	86	270	72	72	72	73	4200	99	100	100	100	101	4200	71	72	72	269	86	86	86	86	86	87
86	86	86	86	86	87	150	150	284	150	150	85	86	86	86	86	86	86	86	86	86	86	86	86	86	86	86	86	86	86	86	87	150	285	285	285	285	285	150	85	86	86	86	86	86	86	86	86	87