1	0	0	784	192
10	0	0	392	96
100	0	0	196	48	5	41	42	24	25	26	27	28	40
101	196	0	196	48	12	13	27	28
102	196	48	196	48	12	13	23
103	0	48	196	48	24	25	26	40
11	392	0	392	96
110	392	0	196	48	8	9	10	11	22	27	28
111	588	0	196	48	22	27	28	
112	588	48	196	48	7	22	28
113	392	48	196	48	8	9	10	11	22
12	392	96	392	96
120	392	96	196	48	15	16	17	32	33
121	588	96	196	48	1	2	3	4	14	15	22	29	43
122	588	144	196	48	14	15	29	30	31
123	392	144	196	48	15	16	17	31	32	36	37
13	0	96	392	96
130	0	96	196	48	6	19	20	21	37	40
131	196	96	196	48	17	18	19	34	35
132	196	144	196	48	17	19	35	36	37
133	0	144	196	48	19	20	21	36	37	38	39	40