1	0	0	1040	400
10	0	0	520	200
100	0	0	260	100	39	21	22	
101	261	0	260	100	37	35	36
102	261	101	260	100	38
103	0	101	260	100	39	38	18	19	20	22
11	521	0	520	200
110	521	0	260	100	35	17
111	781	0	260	100	10	
112	781	101	260	100	10	11	12	13	14
113	521	100	260	100	14	15	16	17
12	521	200	520	200
120	521	200	260	100
121	781	200	260	100	6	9	10
122	781	300	260	100	31	26	10	1	6	7	8	
123	521	300	260	100	31	29	28	1	4	5	27	43	44	45	46	47	48
13	0	200	520	100
130	0	200	260	100	22	23	
131	261	200	260	100	40	34	33	23	24	
132	261	300	260	100	40	32	30	25	1	3	4	41	42
133	0	300	260	100	22	1	2	