12	64
14
1	1
12
51	300	123	125	95	97
52	300	122	124	94	96
53	300	137	139	109	111
54	300	136	138	108	110
55	300	179	181	151	153
56	300	178	180	150	152
57	300	193	195	165	167
58	300	192	194	164	166
59	300	248	250	220	222
60	300	247	249	219	221
61	300	234	236	206	208
62	300	233	235	205	207
23	37	37	37	37	37	37	37	37	37	37	37	37	37	37	23	24	5300	5400	5300	5400	5300	5400	5300	5400	5300	5400	5300	5400	5300	5400	5300	5400	5300	5400	5300	5400	5300	5400	5300	5400	5300	5400	5300	5400	5300	5400	5300	291	292	293	5300	5400	5300	291	292	293	5300	5400	5300	5400	5300	5400	22
24	5100	5200	5100	5200	5100	5200	5100	5200	5100	5200	5100	5200	5100	5200	22	24	5100	5200	5100	5200	5100	5200	5100	5200	5100	5200	5100	5200	5100	5200	5100	5200	5100	5200	5100	5200	5100	5200	5100	5200	5100	5200	5100	5200	5100	5200	5100	291	292	293	5100	5200	5100	291	292	293	5100	5200	5100	5200	5100	5200	22
24	5300	5400	5300	5400	5300	5400	5300	5400	5300	5400	5300	5400	5300	5400	22	24	5300	5400	5300	5400	5300	5400	5300	5400	5300	5400	5300	5400	5300	5400	5300	5400	5300	5400	5300	5400	5300	5400	5300	5400	5300	5400	5300	5400	5300	5400	5300	291	292	293	5300	5400	5300	291	292	293	5300	5400	5300	5400	5300	5400	22
24	5100	5200	5100	5200	5100	5200	5100	5200	5100	5200	5100	5200	5100	5200	22	24	5100	5200	5100	5200	5100	5200	5100	5200	5100	5200	5100	5200	5100	5200	5100	5200	5100	5200	5100	5200	5100	5200	5100	5200	5100	5200	5100	5200	5100	5200	5100	291	292	293	5100	5200	5100	291	292	293	5100	5200	5100	5200	5100	5200	22
24	5300	5400	5300	5400	5300	5400	5300	5400	5300	5400	5300	5400	5300	5400	22	24	5300	5400	5300	5400	5300	5400	5300	5400	5300	5400	5300	5400	5300	5400	5300	5400	5300	5400	5300	5400	5300	5400	5300	5400	5300	5400	5300	5400	5300	5400	5300	291	264	293	5300	5400	5300	291	264	293	5300	5400	5300	5400	53	54	22
24	5100	5200	5100	5200	5100	5200	5100	5200	5100	5200	5100	5200	5100	5200	22	24	5100	5200	5100	5200	5100	5200	5100	5200	5100	5200	5100	5200	5100	5200	5100	5200	5100	5200	5100	5200	5100	5200	5100	5200	5100	291	292	293	5100	5200	5100	305	306	307	163	164	164	305	306	307	5100	5200	5100	5200	67	68	22
24	5300	5400	5300	5400	5300	5400	5300	5400	5300	5400	5300	5400	5300	5400	22	24	5300	5400	5300	5400	5300	5400	5300	5400	5300	5400	5300	5400	5300	5400	5300	5400	5300	5400	5300	5400	5300	5400	5300	5400	5300	161	0	162	5300	5400	5300	291	292	293	177	178	178	291	292	293	5300	5400	5300	5400	55	56	22
24	5100	5200	5100	5200	5100	5200	5100	5200	5100	5200	5100	5200	5100	5200	36	38	5100	5200	5100	5200	5100	5200	5100	5200	5100	5200	5100	5200	5100	5200	5100	5200	5100	5200	5100	5200	5100	5200	5100	5200	5100	291	292	293	163	164	164	291	292	293	177	178	178	291	292	293	163	164	164	164	69	70	22
24	5300	5400	120	121	121	122	5300	5400	5300	5400	5300	5400	5300	5400	5300	5400	5300	5400	5300	5400	5300	5400	5300	5400	5300	5400	5300	5700	5300	5400	5800	5400	5300	5700	5300	5400	5800	5400	5300	5400	5300	291	292	293	177	178	178	291	292	293	177	178	178	291	292	293	177	178	50	286	286	286	23
24	5100	5200	82	83	83	84	5100	5200	5100	5200	5100	5200	5100	5200	5100	5200	5100	5200	5100	5600	5500	5200	5100	5600	5500	5200	5100	66	5100	5200	66	5200	5100	66	5100	5200	66	5200	5100	5200	5100	291	292	293	177	178	178	291	292	293	177	178	178	291	292	293	177	178	281	281	281	281	22
24	5300	5400	22	23	23	24	5300	5400	120	121	121	121	121	121	121	121	122	5400	5300	55	56	5400	5300	53	54	5400	5300	6200	5300	5400	6100	5400	5300	6200	5300	5400	6100	5400	5300	120	121	121	121	121	121	121	121	121	121	121	121	121	121	121	121	121	121	121	121	121	122	281	22
24	5900	6000	22	23	23	24	5900	6000	82	83	83	83	83	83	83	83	84	6000	5900	69	70	6000	5900	67	68	6000	5900	6000	5900	6000	5900	6000	5900	6000	5900	6000	5900	6000	5900	82	83	83	83	83	83	83	83	83	83	83	83	83	83	83	83	83	83	83	83	83	84	281	22