1	0	0	1040	192
10	0	0	520	96	
100	0	0	260	48	15	11	12
101	260	0	260	48	12
102	260	48	260	48	16
103	0	48	260	48	15	24
11	520	0	520	96
110	520	0	260	48
111	780	0	260	48	3
112	780	48	260	48	1	3	20	21	22	23	16
113	520	48	260	48
12	520	96	520	96
120	520	96	260	48
121	780	96	260	48	1	3	21	20	22	23
122	780	144	260	48	2	3	4	20	21	22	23	17	18	19	25	26	27
123	520	144	260	48	4	5	6	7	27	20	21	28	29	30	31	32	33	34	35	40	41	42
13	0	96	520	96
130	0	96	260	48	14	15	24
131	260	96	260	48
132	260	144	260	48	8	9	10	13	28	29	30	31	32	33	34	35	36	37	38	39	40	41	43	44	45
133	0	144	260	48	13	14	15	24