12	16
14
1	1
17
44	500	133	134	135	132
71	500	172	186	200	214
72	500	214	200	186	172
73	500	225	226	227	224
74	500	239	240	241	238
75	500	287	288	289	286
76	500	301	302	303	300
77	500	227	226	225	224
78	500	241	240	239	238
79	500	289	288	287	286
80	500	303	302	301	300
81	500	168	198	196	170
82	500	169	199	197	171
83	500	182	212	210	184
84	500	183	213	211	185
89	500	339	340	367	368
90	500	353	354	381	382
87	281	85	86	87	188	204	204	204	204	205	281	281	85	86	86
87	281	99	100	101	188	204	204	204	204	205	281	281	99	85	86
87	281	281	281	190	188	191	218	218	218	219	281	281	281	85	86
87	281	8100	8200	217	188	219	281	281	281	281	281	281	281	85	86
105	72	73	8400	9002	188	281	281	281	281	281	281	281	8100	85	86
86	100	101	9000	281	188	281	281	281	281	281	281	88	72	107	86
87	281	281	281	9002	188	8200	281	281	281	281	88	86	86	86	86
87	281	281	281	113	115	8400	281	281	281	88	86	86	86	86	86
87	281	281	281	7600	174	281	281	281	281	99	100	100	100	100	86
87	281	281	7100	7300	188	281	281	281	281	281	281	281	281	281	85
87	4400	4400	4400	113	114	114	115	4400	113	114	114	114	115	281	85
87	150	150	150	285	285	285	285	150	85	86	86	86	87	281	85