12	17
14
1	1
15
43	500	133	134	135	132
71	500	172	186	200	214
72	500	214	200	186	172
73	500	225	226	227	224
74	500	239	240	241	238
75	500	287	288	289	286
76	500	301	302	303	300
77	500	227	226	225	224
78	500	241	240	239	238
79	500	289	288	287	286
80	500	303	302	301	300
81	500	168	198	196	170
82	500	169	199	197	171
83	500	182	212	210	184
84	500	183	213	211	185
85	86	86	86	100	100	100	100	100	100	100	100	100	86	87	281	85	
85	86	86	87	175	175	175	175	175	175	175	175	175	85	87	281	85	
85	86	86	87	204	204	204	204	204	204	204	204	204	85	87	281	85	
85	86	86	87	218	218	218	218	218	218	218	218	218	85	87	281	85	
99	86	86	87	117	118	118	118	118	118	118	118	119	85	87	281	85	
233	99	100	101	281	281	281	281	281	281	7200	7900	281	85	87	281	85	
247	145	281	281	281	281	281	281	281	281	7800	8100	8200	85	87	281	85	
261	159	281	281	281	281	281	281	281	281	281	8300	8400	85	87	281	85	
275	71	72	73	281	281	281	281	281	281	281	281	281	99	101	281	85	
71	107	86	87	8200	281	281	281	281	281	281	281	281	281	281	281	85	
85	86	86	105	73	4300	4300	4300	4300	4300	4300	4300	71	72	72	72	107	
85	86	86	86	87	150	150	150	150	150	150	150	85	86	86	86	86	