12	32
14
1	1
15
41	500	133	134	135	132
71	500	172	186	200	214
72	500	214	200	186	172
73	500	225	226	227	224
74	500	239	240	241	238
75	500	287	288	289	286
76	500	301	302	303	300
77	500	227	226	225	224
78	500	241	240	239	238
79	500	289	288	287	286
80	500	303	302	301	300
81	500	168	198	196	170
82	500	169	199	197	171
83	500	182	212	210	184
84	500	183	213	211	185
86	86	86	86	86	86	86	86	86	86	86	86	86	86	86	86	86	86	86	86	86	86	86	86	86	86	86	86	86	87	281	85
86	86	100	100	100	100	100	86	86	86	100	100	100	100	100	100	86	86	100	100	100	100	100	100	100	100	100	100	86	87	281	85
86	87	175	175	176	281	281	85	86	87	175	175	175	175	175	174	85	87	175	175	175	175	175	175	174	175	176	281	100	101	281	85
86	87	204	204	205	8100	8200	99	100	101	204	204	204	204	204	188	85	87	218	189	204	191	218	218	188	218	219	281	281	281	281	85
86	87	204	103	205	8300	8400	281	190	175	191	218	218	189	204	188	99	101	281	203	204	205	281	281	188	281	281	281	281	281	281	85
86	87	204	204	205	281	7400	7200	203	204	205	281	281	203	204	188	176	281	281	217	218	219	281	7200	188	281	281	88	114	114	114	107
86	87	218	218	219	281	281	281	217	218	219	281	281	203	204	188	205	281	7200	7900	281	281	7600	7303	188	281	88	89	86	86	86	86
86	87	281	113	114	78	256	281	281	281	281	281	281	217	218	188	219	281	7400	8100	8200	7600	7302	281	188	88	89	86	86	86	86	86
86	87	281	85	86	86	270	78	256	281	281	281	281	281	281	188	281	88	114	115	8400	7300	113	114	114	90	86	86	86	86	86	86
86	87	281	85	86	86	86	86	270	78	256	281	281	281	281	188	88	89	86	87	281	281	85	86	86	86	86	86	86	86	86	86
86	87	281	85	86	86	86	86	86	86	270	72	72	4100	71	72	89	86	86	87	4100	4100	85	86	86	86	86	86	86	86	86	86
86	87	281	85	86	86	86	86	86	86	86	86	87	150	85	86	86	86	86	87	150	150	85	86	86	86	86	86	86	86	86	86