1	0	0	512	192
10	0	0	256	96
100	0	0	128	48	14	16	19
101	128	0	128	48	16	19
102	128	48	128	48	16	20
103	0	48	128	48	14	15	16	23	24	2	20
11	256	0	256	96
110	256	0	128	48	17	19	26	27	20	21	22
111	384	0	128	48	8	18	19	26	27
112	384	48	128	48	1	7	8
113	256	48	128	48	17
12	256	96	256	96
120	256	96	128	48	2	9	10
121	384	96	128	48	1	6	7	8	9
122	384	144	128	48	6	7	8	9
123	256	144	128	48	2	5	9	10
13	0	96	256	96
130	0	96	128	48	13	14	28	29	30
131	128	96	128	48	3	29
132	128	144	128	48	3	4	11	12	29
133	0	144	128	48	3	4	13	14	23	24	25	28	29