1	0	0	1392	208					
10	0	0	696	104					
100	0	0	348	52	4	5	6	25	26	27	28	29
101	348	0	348	52					
102	348	52	348	52	17				
103	0	52	348	52	3	4	5	6	17	25	26	27	28	29
11	696	0	696	104					
110	696	0	348	52	7				
111	1044	0	348	52					
112	1044	52	348	52	14				
113	696	52	348	52	7	8	17		
12	696	104	696	104					
120	696	104	348	52	8	9	10	11	17	21	13	16
121	1044	104	348	52	14	15	21	13	22	23	24
122	1044	156	348	52	13	14	15	18	19	21	22	20	23	24
123	696	156	348	52	10	11	12	13	21	16
13	0	104	696	104					
130	0	104	348	52	1	2	3	17	
131	348	104	348	52	9	10	17	16	
132	348	156	348	52	10	16			
133	0	156	348	52					