1	0	0	1872	176													
10	0	0	936	88													
100	0	0	468	44	1	2	3										
101	468	0	468	44													
102	468	44	468	44	24												
103	0	44	468	44	2	3	9	24									
11	936	0	936	88													
110	936	0	468	44													
111	1404	0	468	44													
112	1404	44	468	44	25												
113	936	44	468	44													
12	936	88	936	88													
120	936	88	468	44	28	29	30	31	32	33								
121	1404	88	468	44	14	15	25	26	40								
122	1404	132	468	44	13	14	34	35	36	37	38	39	40					
123	936	132	468	44	12	13	28	29	30	31	32	33	34	35	36	37	38	39						
13	0	88	936	88													
130	0	88	468	44	3	4	5	7	8	9	16	17	18	21	22	23	24
131	468	88	468	44	11	24	27	28	29	30	31	32	33								
132	468	132	468	44	10	12	28	29	30	31	32	33										
133	0	132	468	44	3	4	6	7	18	19	20	23					